{"levels":[
    {"grid":[[
        [1,1,1,1,1,1,1],
        [1,1,1,1,1,1,1],
        [1,1,1,1,1,1,1],
        [1,1,1,1,1,1,1],
        [1,1,1,1,1,1,1],
        [1,1,1,1,1,1,1],
        [1,1,1,1,1,1,1]
    ],[
        [1,1,1,1,1,1,1],
        [1,0,1,0,0,0,1],
        [1,0,1,1,1,0,1],
        [1,0,0,0,0,0,1],
        [1,0,1,0,0,0,1],
        [1,0,0,0,0,0,1],
        [1,1,1,1,1,1,1]
    ]],
    "lights":[
        [[-1,2,2],"0x010000",3],
        [[4,2,-10],"0x000000",3]
    ]}
]}